20
12
SEEEEEEEEEEEEEEEEEES
F  C F             F
F   ZSES SEEES     F
FES  F       F     F
F  w F    S  SEEES F
F  SES   S S F     F
F  F     S   F SEEES
F  SEEEEES   F     F
F            F  SEEF
FEEES SEEEES F  S  F
FS           F     F
SEEEEEEEEEEEESEEEEES